"filename", "language", "Batch", "Markdown", "XML", "Java Properties", "Java", "comment", "blank", "total"
"d:\BACKUP_UBUNTU_PROFILE\develop\simple_bank\.mvn\wrapper\maven-wrapper.properties", "Java Properties", 0, 0, 0, 2, 0, 0, 1, 3
"d:\BACKUP_UBUNTU_PROFILE\develop\simple_bank\README.md", "Markdown", 0, 38, 0, 0, 0, 0, 12, 50
"d:\BACKUP_UBUNTU_PROFILE\develop\simple_bank\mvnw.cmd", "Batch", 102, 0, 0, 0, 0, 51, 36, 189
"d:\BACKUP_UBUNTU_PROFILE\develop\simple_bank\pom.xml", "XML", 0, 0, 66, 0, 0, 21, 12, 99
"d:\BACKUP_UBUNTU_PROFILE\develop\simple_bank\src\main\java\com\inrip\bank\BankApplication.java", "Java", 0, 0, 0, 0, 15, 0, 8, 23
"d:\BACKUP_UBUNTU_PROFILE\develop\simple_bank\src\main\java\com\inrip\bank\common\Constants.java", "Java", 0, 0, 0, 0, 26, 4, 4, 34
"d:\BACKUP_UBUNTU_PROFILE\develop\simple_bank\src\main\java\com\inrip\bank\common\RequestMappings.java", "Java", 0, 0, 0, 0, 10, 5, 3, 18
"d:\BACKUP_UBUNTU_PROFILE\develop\simple_bank\src\main\java\com\inrip\bank\common\Utils.java", "Java", 0, 0, 0, 0, 53, 0, 9, 62
"d:\BACKUP_UBUNTU_PROFILE\develop\simple_bank\src\main\java\com\inrip\bank\config\ApplicationListenerInitialize.java", "Java", 0, 0, 0, 0, 21, 28, 10, 59
"d:\BACKUP_UBUNTU_PROFILE\develop\simple_bank\src\main\java\com\inrip\bank\config\SpringMVCConfig.java", "Java", 0, 0, 0, 0, 15, 7, 8, 30
"d:\BACKUP_UBUNTU_PROFILE\develop\simple_bank\src\main\java\com\inrip\bank\controller\TransactionController.java", "Java", 0, 0, 0, 0, 72, 31, 20, 123
"d:\BACKUP_UBUNTU_PROFILE\develop\simple_bank\src\main\java\com\inrip\bank\controller\exceptions\BadRequestException.java", "Java", 0, 0, 0, 0, 13, 4, 6, 23
"d:\BACKUP_UBUNTU_PROFILE\develop\simple_bank\src\main\java\com\inrip\bank\controller\exceptions\HTTPException.java", "Java", 0, 0, 0, 0, 44, 4, 17, 65
"d:\BACKUP_UBUNTU_PROFILE\develop\simple_bank\src\main\java\com\inrip\bank\controller\exceptions\NotFoundException.java", "Java", 0, 0, 0, 0, 13, 4, 7, 24
"d:\BACKUP_UBUNTU_PROFILE\develop\simple_bank\src\main\java\com\inrip\bank\controller\handlers\HTTPResponseHandler.java", "Java", 0, 0, 0, 0, 173, 4, 75, 252
"d:\BACKUP_UBUNTU_PROFILE\develop\simple_bank\src\main\java\com\inrip\bank\dto\AccountRequestDTO.java", "Java", 0, 0, 0, 0, 19, 4, 11, 34
"d:\BACKUP_UBUNTU_PROFILE\develop\simple_bank\src\main\java\com\inrip\bank\dto\AccountResponseDTO.java", "Java", 0, 0, 0, 0, 30, 4, 16, 50
"d:\BACKUP_UBUNTU_PROFILE\develop\simple_bank\src\main\java\com\inrip\bank\dto\StatusRequestDTO.java", "Java", 0, 0, 0, 0, 17, 10, 9, 36
"d:\BACKUP_UBUNTU_PROFILE\develop\simple_bank\src\main\java\com\inrip\bank\dto\StatusResponseDTO.java", "Java", 0, 0, 0, 0, 56, 16, 18, 90
"d:\BACKUP_UBUNTU_PROFILE\develop\simple_bank\src\main\java\com\inrip\bank\dto\TransactionRequestDTO.java", "Java", 0, 0, 0, 0, 59, 4, 22, 85
"d:\BACKUP_UBUNTU_PROFILE\develop\simple_bank\src\main\java\com\inrip\bank\dto\TransactionResponseDTO.java", "Java", 0, 0, 0, 0, 51, 4, 21, 76
"d:\BACKUP_UBUNTU_PROFILE\develop\simple_bank\src\main\java\com\inrip\bank\model\Account.java", "Java", 0, 0, 0, 0, 38, 12, 18, 68
"d:\BACKUP_UBUNTU_PROFILE\develop\simple_bank\src\main\java\com\inrip\bank\model\Transaction.java", "Java", 0, 0, 0, 0, 70, 21, 30, 121
"d:\BACKUP_UBUNTU_PROFILE\develop\simple_bank\src\main\java\com\inrip\bank\repository\AccountRepository.java", "Java", 0, 0, 0, 0, 10, 9, 6, 25
"d:\BACKUP_UBUNTU_PROFILE\develop\simple_bank\src\main\java\com\inrip\bank\repository\TransactionRepository.java", "Java", 0, 0, 0, 0, 14, 9, 7, 30
"d:\BACKUP_UBUNTU_PROFILE\develop\simple_bank\src\main\java\com\inrip\bank\service\account\AccountLogicalValidator.java", "Java", 0, 0, 0, 0, 36, 19, 12, 67
"d:\BACKUP_UBUNTU_PROFILE\develop\simple_bank\src\main\java\com\inrip\bank\service\account\AccountService.java", "Java", 0, 0, 0, 0, 10, 0, 4, 14
"d:\BACKUP_UBUNTU_PROFILE\develop\simple_bank\src\main\java\com\inrip\bank\service\account\AccountServiceImpl.java", "Java", 0, 0, 0, 0, 70, 12, 31, 113
"d:\BACKUP_UBUNTU_PROFILE\develop\simple_bank\src\main\java\com\inrip\bank\service\account\AccountTransformer.java", "Java", 0, 0, 0, 0, 26, 4, 11, 41
"d:\BACKUP_UBUNTU_PROFILE\develop\simple_bank\src\main\java\com\inrip\bank\service\auth\AuthService.java", "Java", 0, 0, 0, 0, 4, 4, 4, 12
"d:\BACKUP_UBUNTU_PROFILE\develop\simple_bank\src\main\java\com\inrip\bank\service\auth\AuthServiceImpl.java", "Java", 0, 0, 0, 0, 25, 5, 9, 39
"d:\BACKUP_UBUNTU_PROFILE\develop\simple_bank\src\main\java\com\inrip\bank\service\auth\TransactionSecurityInterceptor.java", "Java", 0, 0, 0, 0, 47, 4, 23, 74
"d:\BACKUP_UBUNTU_PROFILE\develop\simple_bank\src\main\java\com\inrip\bank\service\transactionStatus\TransactionStatusService.java", "Java", 0, 0, 0, 0, 6, 4, 3, 13
"d:\BACKUP_UBUNTU_PROFILE\develop\simple_bank\src\main\java\com\inrip\bank\service\transactionStatus\TransactionStatusServiceImpl.java", "Java", 0, 0, 0, 0, 70, 15, 28, 113
"d:\BACKUP_UBUNTU_PROFILE\develop\simple_bank\src\main\java\com\inrip\bank\service\transaction\TransactionLogicalValidator.java", "Java", 0, 0, 0, 0, 10, 20, 6, 36
"d:\BACKUP_UBUNTU_PROFILE\develop\simple_bank\src\main\java\com\inrip\bank\service\transaction\TransactionService.java", "Java", 0, 0, 0, 0, 13, 4, 4, 21
"d:\BACKUP_UBUNTU_PROFILE\develop\simple_bank\src\main\java\com\inrip\bank\service\transaction\TransactionServiceImpl.java", "Java", 0, 0, 0, 0, 139, 47, 41, 227
"d:\BACKUP_UBUNTU_PROFILE\develop\simple_bank\src\main\java\com\inrip\bank\service\transaction\TransactionStatusLogicalValidator.java", "Java", 0, 0, 0, 0, 139, 71, 17, 227
"d:\BACKUP_UBUNTU_PROFILE\develop\simple_bank\src\main\java\com\inrip\bank\service\transaction\TransactionTransformer.java", "Java", 0, 0, 0, 0, 33, 4, 11, 48
"d:\BACKUP_UBUNTU_PROFILE\develop\simple_bank\src\main\resources\application.properties", "Java Properties", 0, 0, 0, 11, 0, 4, 3, 18
"d:\BACKUP_UBUNTU_PROFILE\develop\simple_bank\src\test\java\com\inrip\bank\BankApplicationTestsIT.java", "Java", 0, 0, 0, 0, 465, 133, 132, 730
"d:\BACKUP_UBUNTU_PROFILE\develop\simple_bank\src\test\java\com\inrip\bank\common\UtilTest.java", "Java", 0, 0, 0, 0, 87, 0, 13, 100
"Total", "-", 102, 38, 66, 13, 1999, 606, 738, 3562